111001x10
1x1001110
122112210
12x11xx10
x21113320
110113x20
0001x4x30
000113x20
000001110
